------------t-
/            l
/            -
-            -
-            -
-            -
-            -
-            -
-            -
*            p
------------p-

Salad

2 1
11 1
11 9
2 9